...	Adv	eadtjaldovvedh
almmolašvuođaláhka	N	byögkeleslaake
oahppodirektoráhtta	N	ööhpehtimmiedirektoraate
addit iešluohttámuša	MWE	eadtjaldovvedh
almmuhit	V	bæjhkoehtidh
árvvosmahttit	V	eevtjedh
árvvosmahttit	V	hoksedh
bargobihttá	N	laavenjasse
biddjojuvvot oktii	V	iktedidh
birget	V	bearkanidh
boađus	N	illedahkide
buorebut	A	buerebelaakan
báikkálaččat	Adv	byjreske
dahkat diđolažžan	V	vuerkiehtidh
dattetge	Adv	læjhkan
davvi	N	noerhte
davvisámegiella	N	noerhtesaemien
diehtu	N	bïevnese
digitála	A	digitaale
dovdat	V guerkiehtidh
dábálaš	A	gaskoeh
dádjadit	V	veasodh
dárogiel	N	nöörjen
eallin	N	jielede
eaŋgalsfága	N	eengelskefaage
eaŋgalsgiella	N	eengelsken gïele
eksámen	N	eksaamene
elektrovnnalaš	A	elektrovneles
erenoamášoahpahus	N	sjïereööhpehtimmie
estehtalaš	A	estetihke
fuolaheaddji	N	xxx
fuolahit	V	hoksedh
fylka	N	fylhke
fágalaš	A	faagen
geavahit	V	nåhtadidh
gehččojuvvot oktavuohtan	V	ektesne govlesovvedh 
gelbbolašvuohta	N	maahtaldahke
gelbbolašvuođamihttomearri	N	maahtaldahkeulmie
gielalaš	A	gïeleldh		
giellagelbbolašvuođas	N	gïelemaahtaldahke
giellaoahpahus	N	gïeleööhpehtimmie
giellaovdáneapmi	N	gïeleevtiedimmie
giellarádji	N	gïeleraajoe
giellavuogádat	N	gïele bigkesovveme
gulahallan	N	gaskesadteme
gulahallat	V	gaskesadtedh
gullat oktii	V	ektesne govlesovvedh 
guorahallat	V	goerehtalledh
gálga	N	maahtoe
gálgadássi	N	maehtelesvoetedaltese
hálddašit	V	maehtedh
identifiseret	V	identifiseeredh
identitehta	N	identiteete
iešguđet ládje	Adv	joekehtslaakan
ipmirdit	V	goerkesidh
ipmárdus	N	goerkesimmie
iskkus	N	pryövenasse
iskkusbohtosat	MWE	illedahkh pryövenasseste
iskkusáigi	N	pryövenassetïjje
jahkeceahkki	N	jaepietsiehkie
jietnadeapmi	N	tjoejenasse
julevsámegiella	N	julevsaemien
jurddašeapmi	N	åssjaldahke
jávohisvuođageasku	N	sjeavohtsvoetediedte
kritihkalaš	A	kritihke
kultuvrralaš	A	kulturelle
kvaliteahtta	N	kvaliteete
lihkostuvvat	V	lyhkesidh
lohkan	N	lohkeme
lohkanáddejupmi	N	lohkemegoerkese
lohku	N	taale
luvvema addit	MWE	baajedh slyöhpedh
láhčit	V	sjïehteladtedh
makkár iskkus	MWE	pryövenassesåarhte
matematihkka	N	matematihke
mearridit	V	nænnoestidh
mearriduvvon	A	vihties
media	N	meedije
mediaduohtavuohta	N	medijan aarke
movttiidahttit	V	skreejrehtidh
movttiidahttit	V	eevtjedh
máŋggagielalaš	A	gelliegïeleldh
máŋggaválljenbargobihttá	N	jienebeveeljemelaavenjasse
nationála	A	nasjonaale
neahttasiidu	N	nehtesæjroe
oahpaheaddji	N	lohkehtæjja
oahpahus	N	lïerehtimmie
oahppanproseassa	N	lïereme
oahppoplána	N	learoesoejkesje
oaivil	N	åssjele
oassi	N	biehkie
oassi	N	bielie
oassálastit	V	meatan årrodh
oppalašárvosátni	N	elliesvïhnesjimmie
ovdanbuktit	A	soptsestidh
ovdanbuktit	V	buektedh åvtese
ovddeš	A	aarebi
ovddidit	V	skearkagidh
ovdánahttit	V	skearkagidh
ovttaskas	A	aktegs
ovttaskas	A	såemies
privatista	N	privatiste
rastá	Po	dåaresth
rehkenastin	N	ryökneme
rektor	N	rektore
sensureret	V	vierhtiedidh
servodat	N	siebriedahke
sámegielfága	N	saamienfaage
sátneriggodat	N	baakoeveahka
teakstabuvttadeapmi	N	teekstetjaeleme
teakstačállin	N	teekstetjaeleme
viiddis	A	vijries
vuohki	N	öörnege
vuosttašgiella	N	voestesgïeli
vuođđogálga	N	vihkielommes maehtelesvoete
vuođđu	N	våarome
váikkuhit	V	dïjpedh
váldit oktavuođa	MWE	gaskesadtedh
váldonjuolggadus	N	åejvienjoelkedasse
árka	N	paehpere
árvovuođđu	N	aarvoevåarome
árvvoštallan	N	vierhtiedimmie
árvvoštallat	V	vierhtiedidh
árvvoštallat	V	vuarjasjidh
ávki	N	nåhtoe
čiekŋudanfága	N	gïehtjedimmiefaage
čiekŋudeapmi	N	gïehtjedimmie
čoavdit	V	darjodh
čála	N	tjaalege
čálalaččat	Adv	tjaaleldh
V	ektienidh
V	guarkedh
V	krööhkedh
V	vuavkasjidh
